######################################################################################################################
#·······$····#···🍶········~~····················································#################  NAME:             #
#············#·············~~···················································#####····🌑···#### CLASS:             #
#············#·············~~····················································###··········###                    #
########·····#·············~~·····················································###······######                    #
#············#·············~~······················································###·##########---STATISTICS-------#
#······#######·····🍶·······~~··································································#    HP:             #
#············#·············~~···································································#   DMG:             #
########🚹#####·············~~···································································#   STR:             #
#···························~~··································································# ARMOR:             #
#🚹####################·······~~·································································#   INT:             #
#·###················#·······⛇··································································#                    #
#·###·#·#·##··########········~~································································#--INVENTORY---------#
#·###·#·#···#········#·········~~·······························································# Item       |  Wt.  #
#·····#####·########·#··········~~······························································#            |       #
######·········#·····#···········~~·····························································#            |       #
####···#####·###·#####···········~~·····························································#            |       #
#··#·#·#···#·#·······#············~~····························································#            |       #
#····#·#·#·#·#··###·#············~~·····························································#            |       #
#··#···#·#·#·##··##·##·············~~···························································#            |       #
#··###···#·#······#··#·············~~···························································#            |       #
#··#···###·#########·#·············~~·································###########################            |       #
#🍶·#·····#·····$#⛑··#·············~~··························································🗡#            |       #
######################################################################################################################
#                                                                                                                    #
#                                                                                                                    #
#                                                                                                                    #
#                                                                                                                    #
######################################################################################################################
