######################################################################################################################
############################################################################····················#  NAME:             #
##################################################··············································# CLASS:             #
#################################################···············································#                    #
#🍶······························································································#                    #
###··############################################···············································#---STATISTICS-------#
###··############################################🍶··············································#    HP:             #
####··##############################################············································#   DMG:             #
###··###🚹################################################·······································#   STR:             #
#···············🍶################################################·······························# ARMOR:             #
#🐲######################################························································#   INT:             #
#·###··##################·······································································#                    #
#·###··####################################·····················································#--INVENTORY---------#
#·###··############################################·············································# Item       |  Wt.  #
######···········########################################·······································#            |       #
######🍶·#######··##################·########################······························#######            |       #
############🍶·····##############################··#·············································#            |       #
#################··##############################···············································#            |       #
############····#########·#·######··######···········######·····································#            |       #
############·##########···######·######·················######··································#            |       #
##########··W_W··####################·######············~·······································#            |       #
#######····<>T<>····########################################····································#            |       #
#######·3~~M[@]M~~E·····###########################################·····························#            |       #
######################################################################################################################
#                                                                                                                    #
#                                                                                                                    #
#                                                                                                                    #
#                                                                                                                    #
######################################################################################################################
